11111111111111111111111111111111111111111111111111
11111111111111111111111111111111111111111111111111
11111111111111111111111111111111111111111111111111
11111111111111111111111111111111111111111111111111
11111111111111111111114100411111111111111111111111
11111111111111111111141111141111111111111111111111
11111441114411111110011111114111144111111441111111
11111111111111001111111111111411111111111111111111
22111111111111111111111111111141111111111111111113
00000000001100000000000001100000011000000110001100