21101110011111110110
00111011110100011100
00100100000111000010
01100111111001111110
01000010100000000001
11111110001111111111
10100010111010000010
10011110100110111010
01000100100010101110
01110110111100110000
01011100000100011110
01000011110100000010
01111110010101111111
00100000010101010001
11111111110101011101
10100010000101100101
10111100111100101101
10100111100011101011
10001010001110001100
11111011100011110113